#######################
#  > ####   ##@     ###
#    ##     ####### ###
## #### #   ###  +   ##
## #### #######/+### ##
## ####          ### ##
##      ###### /    +##
#######################
