########################
##>   ####   ##       @#
##    ##     ####### ###
### #### #   ###      ##
###### #######  ### ## #
### ####          ### ##
###      ######       ##
########################
