#######################
#  > ####   ##@   @ ###
#    ##     ####### ###
## #### #   ###      ##
## #### #######  ### ##
## ####          ### ##
##      ######       ##
#######################
