#######################
#  > ####   ##@     ###
#    ##     ####### ###
## #### #   ###      ##
## #### #######  ### ##
## ####          ### ##
##      ######       ##
### ###################
