#######################
#  > ####   ##      ###
#    ##     ####### ###
## #### #   ###      ##
## #### #######  ### ##
## ####          ### ##
##      ######       ##
#######################
