#######################
#  > ####   ##@     ###
#    ##     ####### ###
## #### #   ###      ##
## #### #######  ### ##
#######          ### ##
##      ######       ##
#######################
