#######################
#    ####   ##@     ###
#    ##     ####### ###
## #### #   ###      ##
## #### #######  ### ##
## ####          ### ##
##>     ######       ##
#######################
