#######################
#  > #       #@     ###
#    ##     ####### ###
## #### #   ###      ##
## #### #######  ### ##
## ####          ### ##
##      ######       ##
#######################
