#######################
#  > ####   ##@     ###
#    ##     ####### ###
## #### #   ###  +   ##
## #### #######+~### ##
## ####          ### ##
##      ######       ##
#######################
